            NO           ./textures/planks.xpm                  


SO ./textures/bark.xpm

WE ./textures/bark.xpm

EA ./textures/planks.xpm


        C    190,                       190                 ,00000000255
                 
            F        0,150,0

                 1111111111111111111111111
                 1000W00000110000000000101                
                 10110000011100000000000011                    
                 1100100000000000000000000111                
        11111111110110000011100000000000011                  
        1100000001110000011101011101111111                   
        1111001111 111001110000010001
         1111011111111001 1010100100111
        11000000110101001110000010001
        10000000000000000000000000001
        1000000000000000000000000000111
        1100000111010101111101111000001
        11110111 1110101 10111101000111
        11111111 11111111111111111111

























































