            NO                             ./maps/intra_map.cub 


SO ./srcs/main.c

WE ./maps/intra_map.cub 

EA ./maps/intra_map.cub



        F    220,            00000120   ,11
                 
            C                225,33,1

          1111111111111111111111111 
          1000000000110000000000111                
          10110000011100000000000011                    
          1100100000000000000000000111                 
 11111111110110000011100000000000011
 1100000001110000011101011101111111
 1111001111 111001110000010001
  1111011111111001 1010100100111
 11000000110101001110000010001
 10000000000000001100000010001
 1000000000000000110101001000111
 11000001110101011111011110W0001
 11110111 1110101 10111101000111
 11111111 11111111111111111111
