NO   ./textures/bookshelf.xpm
SO   ./textures/bookshelf.xpm
WE  ./textures/bookshelf.xpm
EA  ./textures/bookshelf.xpm

F    254,23,34


C        23            ,1,59


1111111111111111111111
10000000000000000000011          
10000100000000000100011          
10000000000001000000011          
10000000010000000000011          
10000100000000000100011          
100000000000000000000N1          
11111111011111111111111
10100100011
10001000011
10100000011
10000000011
11111111111




