NO   
SO   
WE  
EA  

F    254,23,34


C        23,1,59



11111111111
10001110111          
1000000N011
10000110001
10000000001
11111111111




